GGI    OGG
GG      GG
GG      GG
GG      GG
GG      GG
GG      GG
GG      GG
GG      GG
GG      GG
GG      GG
GG      GG
GG      GG
GG      GG
GG      GG
GG      GG
GG      GG
GG      GG
GG      GG
GG      GG
GG      GG
GG      GG
GG      GG
GG      GG
GG      GG
GG      GG
GG      GG
GG      GG
GG      GG
GG      GG
GG      GG
GG      GG
GG      GG
GG      GG
GG      GG
GG      GG
GG      GG
GG      GG
GG      GG
GG      GG
GG      GG
GG      GG
GG      GG
GG      GG
GGGK  LGGG
GHGG  GGGG
SSSS  SSSS