GGI    OGG
GG      GG
GG  GG  GG
GG  GG  GG
GG      GG
GGG    GGG
GGG    GGG
GGG    GGG
GG      GG
GG  GG  GG
GG  GG  GG
GG      GG
GG      GG
GG  GG  GG
GG      GG
GG      GG
GG  GG  GG
GG  GG  GG
GG      GG
GG      GG
GG  GG  GG
GG  GG  GG
GG      GG
GG GGGG GG
GG GGGG GG
GG GGGG GG
GG      GG
GG  GG  GG
GG  GG  GG
GG  GG  GG
GG  GG  GG
GG      GG
GG      GG
GG      GG
GG  KL  GG
GG  GG  GG
GG  GG  GG
GG  GG  GG
GG  IO  GG
GG      GG
GG      GG
GG      GG
GG      GG
GGGK  LGGG
SSSS  SSSS